NO /Users/insjang/cub3D/imgs/dogeye.XPM
SO /Users/insjang/cub3D/imgs/dogeye.XPM
WE /Users/insjang/cub3D/imgs/dogeye.XPM
EA /Users/insjang/cub3D/imgs/dogeye.XPM

F 220,90,15
C 225,30,0

111111111111111
1100000010000001
1100000000000001
1101110000000001
1110000000000001
1111011000000001
1000000000000001
1000000000000001
100000000N000001
1000000000000001
1000000000000001
111111111111111
