NO ./imgs/no.xpm

F 255,00,0
WE ./imgs/we.xpm
C 150,100,150
EA ./imgs/ea.xpm
SO ./imgs/so.xpm

111111111111111
1100000010000001
1100000000000001
1101110000000001
1111111101111111
       101
1111111101111111
1110000000000001
1111011000000001
1000000000000001
1000000000000001
100001000000001
1000011110000001
100000001N100001
111111111111111