        N111111111111111111111111
        1000000000000000000000021
        1200000000000001111111111
        1000200000000001
111111110000000000000001
10000000000000000000000011111
11111111111111110000000000001
10000000000000010000000000001
10000111111111110000000000001
10200000000000000000000000001
10000000000000011111100000001
1001111111000001    100000011
10000011 1000001    100000001
11111111 1111111    111111111
