        111111111 111111111111111
        100000201 100000000000001
        120000001 100000000000001
        100000001 100000000000001
111111111000000000000000000000001
10000000000000N000000000000001111
10000000000000000000111111111
10000000000000000001
10000000000000000000111111111
10000000000000000000000000001
10000000000000000001010000001
11000001110101011111011110101
11110111 1110111 111111110001
11111111 1111111 111111111111
